Саврас Екатерина Юрьевна

Личная информация

Гражданство: Республики Беларусь
Место проживания: г.Минск
Образование: Высшее
Дата рождения: 30 апреля 1995 (25 лет)
Пол: Женский
Семейное положение: Замужем

Опыт рыботы

Период работы: август 2018 - май 2020
Должность: Врач общей практики

Образование

Учебное заведение: БГМУ
Год окончания: 2018 
Факультет: Лечебное дело
Специальность: Врач общей практики
Форма обучения: Очная

Курсы и тренинги

Интерактивный курс: HTML academy 
Видео курс: ITVDN
Специальность: Frontend-разработчика



Дополнительная информация

Иностранные языки: Английский (Pre-Intermediate)
Наличие водительских прав (категории): В
Занятия в свободное время: Читаю профильную литературу и сайты,
изучаю английский язык, интерисуюсь психологий,
играю в теннис, занимаюсь йогой.
Личные качества: коммуникабельность, ответственность, целеустремленность, 
активная жизненная позиция, отсутствие вредных привычек.

Контактная информация 





